21 21 21 21 21 21 21 21 21 21 21 21 21 21 21 21 21 21 21 21 21 21 21 21 21 21 21 21 21 21 21 21 21 21 21 21 21 21 21 21 21 21 21 21 21 21 21 21 21 21 
21 21 21 21 21 21 21 21 21 21 21 21 21 21 21 21 21 21 21 21 21 21 21 21 21 21 21 21 21 21 21 21 21 21 21 21 21 21 21 21 21 21 21 21 21 21 21 21 21 21 
21 21 21 21 21 21 21 21 21 21 21 21 21 21 21 21 21 21 21 21 21 21 21 21 21 21 21 21 21 21 21 21 21 21 21 21 21 21 21 21 21 21 21 21 21 21 21 21 21 21 
21 21 21 21 21 21 21 21 21 21 21 21 21 21 21 21 21 21 21 21 21 21 21 21 21 21 21 21 21 21 21 21 21 21 21 2 2 2 2 21 21 21 21 21 21 21 21 21 21 21 
21 21 21 21 21 21 21 21 21 21 21 21 21 21 21 21 21 21 21 21 21 21 21 21 21 21 21 21 21 21 21 21 21 21 2 2 2 4 2 21 21 21 21 21 21 21 21 21 21 21 
21 21 21 21 21 21 21 21 21 21 21 21 21 21 21 21 21 21 21 21 21 21 21 21 21 21 21 21 21 21 21 21 21 21 2 4 2 2 2 21 21 21 21 21 21 21 21 21 21 21 
21 21 21 21 21 21 21 21 21 21 21 21 21 21 21 21 21 21 21 21 21 21 21 21 21 21 21 21 21 21 21 21 21 2 2 2 2 2 2 2 2 21 21 21 21 21 21 21 21 21 
21 21 21 21 21 21 21 21 21 21 21 21 21 21 21 21 21 21 21 21 21 21 21 21 21 21 21 21 21 21 21 21 2 2 2 2 2 2 2 2 2 2 2 21 21 21 21 21 21 21 
21 21 21 21 21 21 21 21 21 21 21 21 21 21 21 21 21 2 2 2 2 2 2 2 2 2 2 21 21 21 21 2 2 2 3 3 2 2 2 2 2 2 2 2 21 21 21 21 21 21 
21 21 21 21 21 21 21 21 21 21 21 21 21 21 21 21 2 2 2 19 19 19 2 2 2 2 2 2 2 2 2 2 3 2 2 3 3 3 2 2 2 2 2 2 21 21 21 21 21 21 
21 21 21 21 21 21 21 21 21 21 21 21 21 21 21 21 2 19 19 19 2 3 2 2 2 2 2 2 2 2 2 3 2 2 2 2 2 2 2 2 2 2 2 2 21 21 21 21 21 21 
21 21 21 21 21 21 21 21 21 21 21 21 21 21 21 21 2 19 3 3 3 2 2 2 2 2 2 2 2 2 2 3 2 2 2 2 2 2 2 3 2 2 2 21 21 21 21 21 21 21 
21 21 21 21 21 21 21 21 21 21 21 21 21 21 21 21 2 2 3 3 2 3 3 2 2 2 2 2 2 2 2 3 2 2 2 2 2 2 2 2 2 2 21 21 21 21 21 21 21 21 
21 21 21 21 21 21 21 21 21 21 21 21 21 21 21 21 2 2 2 2 2 2 2 5 5 5 5 5 2 2 2 2 2 2 2 3 3 2 2 2 2 21 21 21 21 21 21 21 21 21 
21 21 21 21 21 21 21 21 21 21 21 21 21 21 21 21 2 2 2 2 5 5 5 5 5 5 5 5 5 5 5 2 2 2 2 3 2 2 2 2 2 2 21 21 21 21 21 21 21 21 
21 21 21 21 21 21 21 21 21 21 21 21 21 21 2 2 2 2 2 5 5 5 5 5 5 5 5 5 5 5 5 2 2 2 2 2 2 2 2 2 2 2 2 21 21 21 21 21 21 21 
21 21 21 21 21 21 21 21 21 21 21 2 2 2 2 2 2 2 5 5 5 5 5 5 5 5 5 5 5 5 2 2 2 2 2 3 2 2 2 2 2 2 2 2 21 21 21 21 21 21 
21 21 21 21 21 21 21 21 21 21 21 2 2 2 2 2 2 2 5 5 5 5 5 5 5 5 5 5 5 2 2 2 2 2 2 3 3 2 3 2 2 2 2 2 2 2 21 21 21 21 
21 21 21 21 21 21 21 21 21 21 2 2 2 3 2 2 2 2 5 5 5 5 5 5 5 5 5 5 2 2 2 2 2 2 2 2 2 2 2 2 2 2 2 2 2 2 21 21 21 21 
21 21 21 21 21 21 21 21 21 2 2 2 2 2 2 2 2 2 2 5 5 5 5 5 5 5 2 2 2 2 2 2 2 2 2 2 2 2 2 2 2 2 2 2 2 2 2 2 21 21 
21 21 21 21 21 21 21 21 21 2 2 2 2 3 3 3 2 2 2 2 2 2 2 5 2 2 2 2 2 2 2 2 2 21 21 2 2 2 2 2 2 2 2 2 2 2 2 2 21 21 
21 21 21 21 21 21 21 21 21 2 3 3 2 2 2 2 2 3 2 2 2 2 2 2 2 2 2 2 2 2 21 21 21 21 21 2 2 2 2 2 20 20 20 20 20 2 2 2 21 21 
21 21 21 21 21 21 21 21 2 2 2 2 2 2 19 19 2 2 2 2 2 2 21 21 21 21 21 21 21 21 21 21 21 21 21 21 2 2 2 2 20 1 1 1 20 2 2 2 2 21 
21 21 21 21 21 21 21 21 2 2 2 2 2 19 19 19 19 19 3 2 2 21 21 21 21 21 21 21 21 21 21 21 21 21 21 21 2 2 2 2 20 1 1 1 20 2 2 2 2 21 
21 21 21 21 21 21 21 21 2 2 2 2 3 19 19 19 19 19 2 2 2 21 21 21 21 21 21 21 21 21 21 21 21 21 21 2 2 2 2 2 1 1 1 1 20 2 21 21 21 21 
21 21 21 21 21 21 21 21 21 2 2 2 19 19 19 19 19 19 2 2 2 2 21 21 21 21 21 21 21 21 21 21 21 21 2 2 2 2 2 2 20 1 1 1 20 2 21 21 21 21 
21 21 21 21 21 21 21 21 21 21 2 2 2 19 19 19 19 19 19 2 2 2 21 21 21 21 21 21 2 21 21 21 21 2 2 2 2 2 2 2 20 1 1 1 20 2 2 21 21 21 
21 21 21 21 21 21 21 21 21 21 21 21 2 2 2 2 19 19 19 2 2 2 2 2 21 21 21 2 2 2 21 2 2 2 0 0 0 2 2 2 20 1 1 1 20 2 2 21 21 21 
21 21 21 21 21 21 21 21 21 21 21 21 2 3 2 2 2 19 2 2 2 2 2 2 2 2 21 2 2 2 2 2 3 2 0 0 0 0 2 2 20 20 20 20 20 2 21 21 21 21 
21 21 21 21 21 21 21 21 21 21 21 21 21 3 3 2 2 3 2 2 2 2 2 2 2 2 2 2 2 2 3 3 0 0 0 0 0 0 2 2 2 2 2 2 2 2 21 21 21 21 
21 21 21 21 21 21 21 21 21 21 21 21 2 2 2 2 2 2 2 2 2 2 2 2 2 2 2 2 2 3 2 2 2 0 0 0 0 0 2 2 2 2 2 2 2 21 21 21 21 21 
21 21 21 21 21 21 21 21 21 21 21 2 2 2 2 2 2 2 2 2 14 12 12 12 12 15 2 2 2 2 2 2 2 2 2 2 2 2 2 2 2 2 2 2 2 21 21 21 21 21 
21 21 21 21 21 21 21 21 21 21 21 2 2 2 2 2 2 2 14 12 13 5 5 5 5 11 12 15 2 2 14 12 12 15 2 2 2 2 2 2 2 2 2 2 21 21 21 21 21 21 
21 21 21 21 21 21 21 21 21 2 2 2 2 2 2 14 12 12 13 5 5 5 5 5 5 5 5 11 15 14 13 5 5 11 12 15 2 2 2 2 2 21 21 21 21 21 21 21 21 21 
21 21 21 21 21 21 21 21 2 2 2 2 2 2 2 10 5 5 5 5 5 5 5 5 5 5 5 5 11 13 5 5 5 5 5 9 2 2 2 2 21 21 21 21 21 21 21 21 21 21 
21 21 21 21 21 21 21 2 2 2 2 2 2 14 12 13 5 5 5 5 6 7 7 7 8 5 5 5 5 5 5 5 5 5 5 9 2 2 2 21 21 21 21 21 21 21 21 21 21 21 
21 21 21 21 21 21 21 2 2 2 2 2 2 10 5 5 5 5 5 5 9 2 2 2 16 7 8 5 5 5 5 5 5 5 5 9 2 2 21 21 21 21 21 21 21 21 21 21 21 21 
21 21 21 21 21 21 2 2 4 2 2 2 10 5 5 5 5 5 5 5 9 2 2 2 2 2 10 5 5 5 5 5 5 5 5 9 2 2 21 21 21 21 21 21 21 21 21 21 21 21 
21 21 21 21 21 2 2 2 2 2 2 2 10 5 5 5 5 5 5 5 9 2 2 21 2 2 10 5 5 5 5 5 5 5 5 9 2 21 21 21 21 21 21 21 21 21 21 21 21 21 
21 21 21 21 21 2 2 4 2 2 2 2 10 5 5 5 5 5 5 9 2 2 21 21 21 2 16 8 5 5 5 5 5 5 6 17 2 2 21 21 21 21 21 21 21 21 21 21 21 21 
21 21 21 21 21 2 2 2 2 2 2 2 16 8 5 5 5 5 9 2 2 2 21 21 21 2 2 10 5 5 5 5 5 5 9 2 2 2 21 21 21 21 21 21 21 21 21 21 21 21 
21 21 21 21 21 21 21 2 2 2 2 2 2 16 8 5 5 6 17 2 2 21 21 21 21 2 2 10 5 5 18 5 5 6 17 2 2 21 21 21 21 21 21 21 21 21 21 21 21 21 
21 21 21 21 21 21 21 21 21 21 21 21 21 2 16 7 7 17 2 2 21 21 21 21 21 2 2 10 5 5 5 5 6 17 2 2 21 21 21 21 21 21 21 21 21 21 21 21 21 21 
21 21 21 21 21 21 21 21 21 21 21 21 21 2 2 2 2 2 2 21 21 21 21 21 21 2 2 10 5 5 5 5 9 2 2 21 21 21 21 21 21 21 21 21 21 21 21 21 21 21 
21 21 21 21 21 21 21 21 21 21 21 21 21 21 21 2 2 2 21 21 21 21 21 21 21 2 2 16 7 7 7 7 17 2 2 21 21 21 21 21 21 21 21 21 21 21 21 21 21 21 
21 21 21 21 21 21 21 21 21 21 21 21 21 21 21 21 2 21 21 21 21 21 21 21 21 21 21 2 2 2 2 2 2 2 2 21 21 21 21 21 21 21 21 21 21 21 21 21 21 21 
21 21 21 21 21 21 21 21 21 21 21 21 21 21 21 21 21 21 21 21 21 21 21 21 21 21 21 21 2 2 2 2 21 21 21 21 21 21 21 21 21 21 21 21 21 21 21 21 21 21 
21 21 21 21 21 21 21 21 21 21 21 21 21 21 21 21 21 21 21 21 21 21 21 21 21 21 21 21 21 21 21 21 21 21 21 21 21 21 21 21 21 21 21 21 21 21 21 21 21 21 
21 21 21 21 21 21 21 21 21 21 21 21 21 21 21 21 21 21 21 21 21 21 21 21 21 21 21 21 21 21 21 21 21 21 21 21 21 21 21 21 21 21 21 21 21 21 21 21 21 21 
21 21 21 21 21 21 21 21 21 21 21 21 21 21 21 21 21 21 21 21 21 21 21 21 21 21 21 21 21 21 21 21 21 21 21 21 21 21 21 21 21 21 21 21 21 21 21 21 21 21 
