21 21 21 21 21 21 21 21 21 21 21 21 21 21 21 21 21 21 21 21 21 21 21 21 21 21 21 21 21 21 21 21 21 21 21 21 21 21 21 21 21 21 21 21 21 21 21 21 21 21 
21 21 21 21 21 21 21 21 21 22 21 21 21 21 21 21 21 21 21 21 21 21 21 21 21 21 21 21 21 21 21 21 21 21 21 21 21 21 21 21 21 21 21 21 21 21 21 21 21 21 
21 21 21 21 21 21 21 21 21 21 21 21 21 21 21 21 21 21 21 21 21 22 21 21 21 21 21 21 22 21 21 21 21 21 31 29 29 29 29 32 21 21 21 21 21 21 21 21 21 21 
21 21 21 22 21 21 21 21 21 21 21 21 21 21 21 21 21 21 21 21 21 21 21 21 21 21 21 21 21 21 21 21 21 31 30 2 2 2 2 26 21 21 21 21 21 21 21 21 21 21 
21 21 21 21 21 21 21 21 21 21 21 21 21 21 21 21 21 21 21 21 21 21 21 21 21 21 21 21 21 21 21 21 21 27 2 2 2 4 2 26 21 21 21 21 21 21 21 21 21 21 
21 21 21 21 21 21 21 21 21 21 21 21 21 21 21 21 21 21 21 21 21 21 21 21 21 21 21 21 21 21 21 21 31 30 2 4 2 2 2 28 29 32 21 21 21 21 22 21 21 21 
21 21 21 21 21 21 21 21 21 21 21 21 21 21 21 22 21 21 21 21 21 21 21 21 21 21 21 21 21 21 21 31 30 2 2 2 2 2 2 2 2 28 29 32 21 21 21 21 21 21 
21 21 21 21 21 21 21 21 21 21 21 22 21 21 21 21 31 29 29 29 29 29 29 29 29 29 29 32 21 21 31 30 2 2 2 2 2 2 2 2 2 2 2 28 21 21 21 21 21 21 
21 21 21 21 21 21 21 21 21 21 21 21 21 21 21 31 30 2 2 2 2 2 2 2 2 2 2 28 29 29 30 2 2 2 3 3 2 2 2 2 2 2 2 2 26 21 21 21 21 21 
21 21 21 21 21 21 21 21 21 21 21 21 21 21 21 27 2 2 2 19 19 19 2 2 2 2 2 2 2 2 2 2 3 2 2 3 3 3 2 2 2 2 2 2 26 21 21 21 21 21 
21 21 21 21 21 21 21 21 21 21 21 21 21 21 21 27 2 19 19 19 2 3 2 2 2 2 2 2 2 2 2 3 2 2 2 2 2 2 2 2 2 2 2 2 26 21 21 21 21 21 
21 22 21 21 21 21 21 21 21 21 21 21 21 21 21 27 2 19 3 3 3 2 2 2 2 2 2 2 2 2 2 3 2 2 2 2 2 2 2 3 2 2 2 23 34 21 21 21 21 21 
21 21 21 21 21 21 22 21 21 21 21 21 21 21 21 27 2 2 3 3 2 3 14 12 12 12 12 12 15 2 2 3 2 2 2 2 2 2 2 2 2 2 23 34 22 21 21 21 21 21 
21 21 21 21 21 21 21 21 21 21 21 21 21 21 21 27 2 2 2 2 12 12 13 5 5 5 5 5 11 12 12 15 2 2 2 3 3 2 2 2 2 23 34 21 21 21 21 21 22 21 
21 21 21 21 21 21 21 21 21 21 21 21 21 21 29 30 2 2 14 13 5 5 5 5 5 5 5 5 5 5 5 9 2 2 2 3 2 2 2 2 2 28 29 32 21 21 21 21 21 21 
21 21 21 21 21 21 21 21 21 21 31 29 29 30 2 2 2 14 13 5 5 5 5 5 5 5 5 5 5 5 5 9 2 2 2 2 2 2 2 2 2 2 2 28 32 21 21 21 21 21 
21 21 21 21 21 21 21 21 21 21 27 2 2 2 2 2 2 10 5 5 5 5 5 5 5 5 5 5 5 5 6 17 2 2 2 3 2 2 2 2 2 2 2 2 28 29 32 21 21 21 
21 21 21 21 21 21 21 21 21 31 30 2 2 2 2 2 2 10 5 5 5 5 5 5 5 5 5 5 5 6 17 2 2 2 2 3 3 2 3 2 2 2 2 2 2 2 26 21 21 21 
21 21 21 21 21 21 21 31 29 30 2 2 2 3 2 2 2 10 5 5 5 5 5 5 5 5 5 5 6 17 2 2 2 2 2 2 2 2 2 2 2 2 2 2 2 2 28 29 32 21 
21 21 21 21 22 21 31 30 2 2 2 2 2 2 2 2 2 16 8 5 5 5 5 5 5 5 6 7 17 2 2 2 2 2 2 2 2 2 2 2 2 2 2 2 2 2 2 2 26 21 
21 21 21 21 21 21 27 2 2 2 2 2 2 3 3 3 2 2 16 7 7 7 8 5 5 6 17 2 2 2 2 2 23 24 24 25 2 2 2 2 2 2 2 2 2 2 2 2 26 21 
21 21 21 21 21 21 27 2 3 3 3 3 2 2 2 2 2 3 2 2 2 2 16 7 7 17 2 2 2 23 24 24 34 22 21 27 2 2 2 2 20 20 20 20 20 2 2 2 28 21 
21 22 21 21 21 21 27 2 3 3 3 2 2 2 19 19 2 2 2 2 2 23 24 24 24 24 24 24 24 34 21 21 21 21 21 27 2 2 2 2 20 1 1 1 20 2 2 2 2 26 
21 21 21 21 21 21 27 2 3 3 2 2 2 19 19 19 19 19 3 2 2 26 21 21 21 21 21 22 21 21 21 22 21 21 21 27 2 2 2 2 20 1 1 1 20 2 2 2 2 26 
21 21 21 21 21 21 27 2 2 2 2 19 2 2 19 19 19 19 2 2 2 28 32 21 22 21 21 21 21 21 21 21 21 21 31 30 2 2 2 2 1 1 1 1 20 2 2 2 23 34 
21 21 21 21 21 21 27 2 2 2 2 19 2 2 2 2 19 19 2 2 2 2 26 21 21 21 21 31 29 32 21 21 21 21 27 2 2 2 2 2 20 1 1 1 20 2 2 2 26 21 
21 21 21 21 21 21 27 2 2 2 2 19 19 2 3 2 19 19 19 2 2 2 28 29 21 22 31 30 2 28 32 21 21 21 27 2 2 2 2 2 20 1 1 1 20 2 2 2 26 21 
21 21 21 21 21 21 33 25 2 2 2 2 19 2 2 2 19 19 19 2 2 2 2 2 28 32 27 2 2 2 26 21 22 31 30 2 0 2 2 2 20 1 1 1 20 2 2 2 26 21 
21 22 21 21 21 21 21 33 25 2 2 2 19 19 19 19 19 19 19 2 2 2 2 2 2 28 30 2 2 2 26 21 21 27 0 0 0 0 2 2 20 20 20 20 20 2 2 2 26 21 
21 21 21 21 21 21 21 21 33 25 2 2 2 3 3 19 19 19 2 2 2 2 2 2 2 2 2 2 2 2 28 32 21 27 20 20 0 0 0 2 2 2 2 2 2 2 2 2 26 21 
21 21 21 21 21 21 21 22 21 27 2 2 0 0 2 2 2 2 2 2 2 2 2 2 2 2 2 2 2 3 2 28 29 30 0 20 20 20 0 0 2 2 2 2 2 2 23 24 34 21 
21 21 21 21 21 21 21 21 21 33 25 2 0 0 0 0 2 2 2 2 14 12 12 12 12 15 2 2 2 2 2 2 2 0 0 0 0 20 20 0 0 2 2 2 2 23 34 21 21 21 
21 21 21 21 22 21 21 21 31 29 30 2 0 0 0 2 2 2 14 12 13 5 5 5 5 11 12 15 2 2 14 12 12 15 2 0 0 0 20 20 0 0 2 2 23 34 21 21 21 21 
21 21 21 21 21 21 21 31 30 2 2 0 0 2 2 14 12 12 13 5 5 5 5 5 5 5 5 11 15 14 13 5 5 11 12 15 2 0 0 20 20 2 23 24 34 21 21 21 21 21 
21 21 21 21 21 21 31 30 2 2 2 0 2 2 2 10 5 5 5 5 5 5 5 5 5 5 5 5 11 13 5 5 5 5 5 9 2 0 0 0 20 23 34 21 21 21 21 21 21 21 
21 21 21 21 21 21 27 2 3 2 2 2 3 14 12 13 5 5 5 5 6 7 7 7 8 5 5 5 5 5 5 5 5 18 5 9 2 2 2 2 23 34 21 21 21 21 21 21 21 21 
21 21 21 21 21 31 30 2 2 2 2 2 14 13 5 5 5 5 5 5 9 2 3 2 16 7 8 5 5 5 5 5 5 5 5 9 2 2 23 24 34 21 22 21 21 21 21 21 21 21 
22 21 21 21 31 30 2 2 4 2 2 2 10 5 5 5 5 5 5 5 9 2 2 2 2 2 10 5 5 5 5 5 5 5 5 9 2 23 34 21 21 21 21 21 21 21 21 21 21 21 
21 21 21 21 27 2 2 2 2 2 2 2 10 5 5 5 5 5 5 5 9 2 2 2 2 2 10 5 5 5 5 5 5 5 5 9 2 28 32 21 21 21 21 21 21 21 21 21 21 21 
21 21 21 21 27 2 2 4 2 3 2 2 10 5 5 5 5 5 5 9 2 2 23 24 25 2 16 8 5 5 5 5 5 5 6 17 2 2 26 21 22 21 21 21 21 21 21 21 21 21 
21 21 21 21 27 2 2 2 2 2 2 2 16 8 5 5 5 5 9 3 2 2 26 21 27 2 2 10 5 5 5 5 5 5 9 2 2 2 26 21 21 21 21 21 21 21 22 21 21 21 
21 21 21 21 33 24 25 2 2 2 2 2 2 16 8 5 5 6 17 2 2 23 34 21 27 2 2 10 5 5 5 5 5 6 17 2 2 23 34 21 21 21 21 21 21 21 21 21 21 21 
21 21 21 21 21 21 33 24 24 24 24 24 25 2 16 7 7 17 2 2 23 34 21 21 27 2 2 10 5 5 5 5 6 17 2 2 23 34 21 21 21 21 21 21 21 21 21 21 21 21 
21 21 21 21 21 21 21 21 21 21 21 21 27 2 2 2 3 2 2 23 34 21 22 21 27 2 2 10 5 5 5 5 9 2 2 23 34 21 21 21 21 21 21 21 21 21 21 21 21 21 
21 21 21 21 21 21 21 21 21 21 22 21 33 24 25 2 2 2 23 34 21 21 21 21 27 2 2 16 7 7 7 7 17 2 2 26 21 21 21 21 21 21 21 21 21 21 21 21 21 21 
21 21 21 21 21 21 21 21 21 21 21 21 21 21 33 25 2 23 34 21 21 21 21 21 33 24 25 2 2 2 2 2 2 2 2 26 21 21 22 21 21 21 22 21 21 21 21 21 21 21 
21 21 22 21 21 21 21 21 21 21 21 21 21 21 21 33 24 34 21 21 21 21 21 21 21 21 33 25 2 2 2 2 23 24 24 34 21 21 21 21 21 21 21 21 21 21 21 22 21 21 
21 21 22 21 21 21 21 21 21 21 21 21 21 21 21 21 21 21 22 21 21 21 21 21 21 21 21 33 24 24 24 24 34 21 21 21 21 21 21 21 21 21 21 21 21 21 21 21 21 21 
21 21 21 21 21 21 22 21 21 21 21 21 21 21 21 21 21 21 21 21 21 21 21 21 22 21 21 21 21 21 21 21 21 21 21 21 21 21 21 21 21 21 21 21 21 21 21 21 21 21 
21 21 21 21 21 21 21 21 21 21 21 21 21 21 21 21 21 21 21 21 21 21 21 21 21 21 21 21 21 21 21 21 21 21 21 21 21 21 21 21 21 21 21 21 21 21 21 21 21 21 
